MMMMMMM
MO C OM
M     M
MC P CM
M     M
MO C OM
MMMMMMM