  MMM  
  MOM  
MMMCMMM
MOCPCOM
MMMCMMM
  MOM  
  MMM  
