MMMMMMM
MOCPCOM
MMMCMMM
  MOM
  MMM

